           1111111111111111111111111
           1000000000110000000000001
           1011000001110000000000001
           1001000000000000000000001
   111111111011000001110000000000001
   100000000011000001110110111111111
11110111111111011100000010001
11110111011111011101010010001
11000001110101011100000010001
10000000000000001100000010001
10000000000000001101010010001
11000001110101011111011100N0111
11110111 1110101 111011010001
11111111 1111111 110011111101
 111111111111111110011111110111
 1111111100000001000000100001
  100000001111101111110111101
  11011110100000000000010000111
  110011101011111111110001100011
1111111111111111111111111111111