NO     art/wood.xpm   

F     94,164,96
C     0,0,255


 111111  
10000001 
100000001
100000001
100000001
1000N0001
111111D11
100000001
100D00001
100000001
11000D011
 111111 
