
 111111
10000001
100000001
100000001
100000001
1000N0001
100000001
100000001
100000001
110000011
 111111
