F     94,164,96    G#RPIUGR#wl3wrug
C     0,0,255


 111111  
10000001 
100000001
100000001
100000001
1000N0001
111111111



100000001
100000001
100000001
110000011
 111111       

