NO  art/eagle.xpm

111111111
101000101
100010001
101000011
1000N0001
100000011
110111111
111111111