1111111111111111111111111
100000000000D000000000001
100000000000D000000000001
100000000000D000000000001
100000000DDDDDDDDD0000001
100000000000D000000000001
100000000000D000000000001
1000000000000000000000001
100000000000D000000000001
100000000000N000000000001
1000000000000000000000001
1000000000000000000000001
1000000000000000000000001
1000000000000000000000001
1111111111111111111111111
